  	 C   102, 	 51 ,	 53   
 	R  		 600 	600 	
 	F  	56 , 34 , 45  
 	 NO		 /Users/mstyr/pics/greystone.xpm 	
 	SO  	 /Users/mstyr/pics/greystone.xpm 	

 	EA  	/Users/mstyr/pics/bluestone.xpm 	
 	WE		 /Users/mstyr/pics/colorstone.xpm 	
 	S 		 /Users/mstyr/pics/barrel.xpm 		


111111111111111111111111
1111000001100000000000011
10110000011100000022200W01
10010000000000000000000011111111111
1111111110110000011100011111111111
1000000000110000011101111111111111
1111011111111101110000001
11110111111111011101010011
110000001101010111000000001
10000000000000001100000011
10000000000000001101010011
1100000111010101111101111
1111011111101011011110101
111111111111111111111111111